 --- --- --- --- --- --- --- --- --- 
| v             |                   |
     ---         ---     ---         
|           |   |obs|   |   |       |
 ---         --- --- ---     ---     
|       |   |obs| x                 |
         --- --- --- --- ---         
|   |   |obs|           |           |
         ---         ---     ---     
|   |           |           |       |
 --- --- --- --- --- --- --- --- --- 